#########
#.......#
#..._...#
#..###..#
#..*....#
#.......#
#########
